111110000011111100110411111030000011000121011001100000001001300101202001111100011011111111111001111130000001111111111111111111111111111111111111
111000100111000000100001001010101001101010101000101313131000101111111101100000000001100002001001101002001101400002000001110000000001111111111111
311100000000011102010101011005010010011002010100011100010000010010113000000000001100001010100101000000001100010010000000010100010001101401000100
300111110003000000000000101110111010101000001010101210121010100004000010111000001110011010101010001200021010000001000010011111111010310000001003
000100101003101010000000000001010101010100000100000001010110010100010000000010100100010000100001000100001100000001000001121001010001401000000111
340010300000131000111100101110100100100000000100100010100001110000000000100111011111000000500000101001000200100101000020000111000200101001000000
010010001000000000000100100001001000001010000010100100010000031000100010410100000000001000101010121101000010001010101000000000000010011010101000
140110000003010000101310100001300030000100101010010001300003110000001000000100101011020011000100020200010000020000001013002220000000000000010011
314000000003001011010100000220000010010001301010001010100000100020201100101005000010000020001000001100100101100010010000001001001010030000000003
100101000130001000010201010101101100000000031001101030110000000042001010102010100100001000010001010101001100300000022310101010101000000000000101